info {
bg:1
}

tiles {
1,1,1,1,1,1,1,1,1,1,1,1,1,1,1,1,1,1,1,1,1,1,1,1,1,1,1,1,1,1,1,1,1,1,1,1,1,1,1,1
1,87,20,88,1,1,1,1,1,1,1,1,1,1,1,1,1,1,1,1,1,1,1,1,1,1,1,1,1,1,87,18,84,80,51,51,51,51,73,1
1,18,20,18,1,1,1,1,1,1,1,1,1,1,1,1,1,1,1,1,1,1,1,1,1,1,1,1,1,1,77,18,77,11,132,0,0,141,49,1
1,20,84,83,1,1,1,1,1,1,1,1,1,1,1,1,1,1,1,1,1,1,1,1,1,1,1,1,1,1,77,131,130,11,11,132,0,141,49,1
1,84,130,29,20,20,70,51,73,1,1,1,1,1,1,1,1,1,1,1,1,1,1,1,1,1,1,1,1,1,77,11,11,11,11,29,52,141,49,1
1,86,128,29,70,51,55,53,20,1,18,18,70,51,51,51,51,51,51,51,73,1,1,1,1,74,51,51,73,1,77,18,11,11,11,29,48,141,49,1
1,20,130,29,48,0,16,20,20,1,18,70,55,0,136,0,0,0,0,0,54,73,1,1,1,48,0,0,49,1,77,18,11,17,11,29,68,52,49,1
1,124,11,60,48,20,0,51,51,51,51,55,0,0,0,0,0,0,0,0,0,49,1,1,1,48,0,0,49,1,77,11,11,11,11,29,18,48,49,1
1,70,25,51,55,140,140,140,140,140,140,140,140,140,140,140,140,140,140,140,140,49,1,1,1,48,0,0,49,1,77,47,11,11,11,29,70,55,49,1
1,48,0,0,0,0,0,0,53,50,52,0,0,0,0,0,0,0,0,0,0,49,19,70,51,55,0,0,54,71,30,11,27,27,27,60,48,141,49,1
1,76,25,25,25,50,52,0,49,1,68,50,50,50,52,0,0,0,0,0,0,54,51,55,0,0,0,0,0,54,25,25,70,51,51,51,55,141,49,1
1,1,31,31,31,1,48,0,20,1,1,1,1,1,76,52,0,0,0,0,0,0,53,50,52,0,0,0,0,0,0,0,0,0,0,0,0,141,49,1
1,1,31,31,31,1,48,53,75,1,1,1,1,1,1,76,52,0,0,0,0,53,69,19,68,50,50,25,25,25,50,50,50,50,50,52,0,141,49,1
1,1,31,31,31,1,76,75,1,1,1,1,1,1,1,1,76,52,0,0,53,75,1,1,1,1,1,89,128,129,18,18,1,1,1,76,52,141,49,1
1,1,31,31,31,1,1,1,1,1,1,1,1,1,1,1,1,48,0,0,49,1,1,1,1,1,1,1,77,131,80,83,1,1,1,1,48,141,49,1
1,1,31,31,31,1,1,1,96,97,98,99,100,1,1,1,1,48,0,0,49,1,1,1,1,1,1,1,77,11,11,78,1,1,1,1,48,141,49,1
1,1,31,31,31,1,1,1,101,102,103,104,105,1,1,1,1,68,52,53,75,1,1,1,1,1,1,1,77,46,27,60,1,1,1,1,48,141,49,1
1,1,31,31,31,1,1,1,106,107,108,109,110,1,1,1,1,1,48,49,1,1,1,1,1,1,1,1,77,29,70,71,1,1,1,1,48,141,49,1
1,1,31,31,31,1,1,1,112,113,114,115,116,1,1,1,1,74,55,49,1,1,1,1,1,1,1,74,25,25,48,49,1,1,1,1,48,141,49,1
1,1,31,31,31,1,1,1,117,118,119,120,121,1,1,1,1,48,0,49,91,51,51,51,51,51,51,55,0,54,55,49,1,1,1,1,48,141,49,1
1,1,31,31,31,1,1,1,1,1,1,1,1,1,1,1,1,48,0,20,21,0,0,53,50,50,50,50,50,50,50,75,1,1,1,1,48,141,49,1
1,1,31,31,31,8,1,1,1,1,1,1,1,1,1,1,7,48,0,20,21,0,53,75,1,1,1,1,1,1,1,1,1,1,1,1,48,141,49,1
1,1,31,31,31,31,31,31,31,19,19,31,31,31,31,31,31,48,0,49,21,53,75,1,96,97,98,99,100,1,1,1,1,1,1,74,55,141,49,1
1,7,31,31,31,31,31,31,31,19,19,31,31,31,31,31,31,48,0,49,21,49,1,1,101,102,103,104,105,1,1,1,74,18,18,48,0,141,49,1
1,19,19,31,31,31,31,31,31,31,31,31,10,1,1,1,1,48,0,49,21,49,1,1,106,107,108,109,110,1,1,74,55,54,18,55,0,141,49,1
1,19,19,31,31,31,31,31,31,31,31,10,1,1,1,1,1,48,0,49,21,49,1,1,112,113,114,115,116,1,74,55,0,0,0,0,0,141,49,1
1,31,31,31,31,31,31,31,31,10,1,1,1,1,1,1,74,55,0,49,21,49,1,1,117,118,119,120,121,1,48,141,53,50,50,52,0,141,49,1
1,9,31,31,31,31,31,31,10,1,1,1,1,1,1,1,48,0,0,54,55,54,51,51,51,51,73,1,1,1,48,141,49,1,1,48,0,141,49,1
1,1,1,1,1,31,31,31,1,1,1,1,1,1,74,51,55,0,0,53,50,50,50,50,52,0,49,1,1,1,48,141,49,1,1,48,0,141,49,1
1,1,1,1,1,31,31,31,1,1,1,1,1,1,76,50,52,0,53,75,1,1,1,1,76,52,49,1,1,1,48,141,49,1,1,48,0,141,49,1
1,1,1,1,1,31,31,31,1,1,1,1,1,1,1,1,76,52,49,1,1,1,1,1,1,48,54,51,51,51,55,141,54,71,1,48,0,141,49,1
1,1,1,1,1,31,31,31,1,1,1,1,1,1,1,1,1,48,49,1,1,1,1,1,1,48,0,0,0,0,0,141,0,49,1,48,0,141,49,1
1,1,1,1,1,31,31,31,1,1,1,1,1,1,1,1,1,20,49,1,1,1,1,1,1,48,0,0,0,0,0,141,0,49,1,76,50,50,75,1
1,1,74,51,51,51,51,51,51,73,1,1,1,1,1,1,1,48,49,1,1,1,1,1,1,48,0,0,0,0,53,50,50,75,1,1,1,1,1,1
1,74,55,0,136,0,0,53,52,49,1,1,1,1,1,1,1,48,54,73,1,1,1,1,74,55,0,53,50,50,75,1,1,1,1,1,1,1,1,1
1,48,0,0,53,50,50,69,18,49,1,1,1,1,1,1,1,68,52,54,51,51,51,51,55,0,0,49,1,1,1,1,1,1,1,1,1,1,1,1
1,48,0,0,49,18,23,23,23,65,1,1,1,1,1,1,1,122,23,23,23,23,23,0,0,0,0,49,1,1,1,1,1,1,1,1,1,1,1,1
1,48,0,0,49,21,0,0,0,54,51,73,1,70,51,51,51,55,0,0,0,0,0,0,0,0,0,54,51,73,1,1,1,1,1,1,1,1,1,1
1,48,0,0,54,21,0,0,0,0,0,54,51,55,0,0,0,0,0,0,0,0,0,0,0,0,0,0,0,49,1,1,1,1,1,1,1,1,1,1
1,48,140,140,140,140,140,140,140,140,140,140,140,140,140,140,140,140,140,140,140,140,140,140,140,140,140,140,53,75,1,1,1,1,1,1,1,1,1,1
1,48,0,0,0,0,0,0,0,0,0,53,50,52,0,0,0,0,0,0,0,0,0,0,0,0,0,53,75,1,1,1,137,138,139,1,1,1,1,1
1,76,50,50,50,50,50,50,50,50,50,75,1,68,50,50,50,50,50,50,50,50,50,50,50,50,50,75,1,1,1,1,1,1,1,1,1,1,1,1
1,1,1,1,1,1,1,1,1,1,1,1,1,1,1,1,1,1,1,1,1,1,1,1,1,1,1,1,1,1,1,1,1,1,1,1,1,1,1,1
}

collision {
(128,160),(192,160),(192,128),(256,128),(288,160),(256,160),(256,192),(224,192),(224,224),(352,224),(352,192),(384,192),(384,160),(640,160),(704,224),(704,288),(704,320),(736,320),(736,288),(800,288),(800,192),(832,160),(896,160),(928,192),(928,288),(960,288),(960,64),(992,32),(992,96),(1024,96),(1024,32),(1216,32),(1248,64),(1248,1024),(1216,1056),(1152,1056),(1120,1024),(1120,864),(1056,864),(1056,960),(1088,960),(1088,1056),(1056,1088),(992,1088),(960,1120),(896,1120),(896,1184),(928,1184),(960,1216),(960,1248),(864,1344),(416,1344),(416,1312),(384,1312),(352,1344),(64,1344),(32,1312),(32,1120),(96,1056),(160,1056),(160,896),(64,896),(32,864),(32,832),(96,832),(96,768),(32,768),(64,736),(64,352),(32,320),(32,224),(64,224),(64,192),(32,192),(32,128),(64,128),(64,96),(128,96),(128,128),(128,160)
(192,224),(192,256),(160,256),(160,224),(192,224)
(288,352),(288,320),(320,320),(320,352),(448,352),(544,448),(544,544),(576,544),(576,576),(544,608),(544,672),(512,704),(352,704),(352,768),(288,768),(288,704),(192,704),(160,672),(160,352),(192,352),(192,416),(224,448),(288,384),(256,384),(256,352),(288,352)
(736,416),(704,416),(672,448),(672,512),(640,544),(640,608),(864,608),(896,576),(896,448),(864,416),(768,416),(768,384),(736,384),(736,416)
(960,448),(1024,448),(1024,640),(992,672),(768,672),(704,736),(704,864),(832,864),(864,896),(864,960),(960,960),(960,832),(1056,736),(1056,768),(1088,768),(1088,800),(1120,800),(1120,736),(1152,704),(1152,448),(1120,416),(960,416),(960,448)
(640,704),(608,704),(608,640),(640,640),(640,704)
(768,928),(800,960),(800,1088),(768,1120),(640,1120),(608,1088),(608,960),(640,928),(768,928)
(544,992),(512,960),(480,960),(448,928),(480,896),(512,896),(512,864),(544,832),(544,768),(416,768),(352,832),(320,832),(256,896),(256,1056),(288,1056),(320,1088),(320,1184),(352,1184),(384,1216),(416,1216),(416,1184),(544,1184),(544,1056),(576,1056),(576,1024),(544,1024),(544,992)
(160,1184),(192,1184),(192,1152),(160,1152),(160,1184)
(288,1152),(288,1120),(256,1120),(256,1152),(288,1152)
(1024,160),(1024,224),(992,224),(992,160),(1024,160)
(1024,256),(1008,288),(992,288),(1008,256),(1024,256)
}

collisionPeople {
(128,128),(128,256),(96,256),(96,248),(120,248),(120,128),(128,128)
(32,232),(32,256),(64,256),(64,248),(40,248),(40,224),(32,232)
(1144,128),(1144,312),(1024,312),(1024,320),(1152,320),(1152,256),(1184,256),(1184,224),(1152,224),(1152,128),(1144,128)
(960,288),(960,320),(968,320),(968,288),(960,288)
(1024,544),(960,544),(960,576),(952,576),(952,536),(1016,536),(1016,512),(1024,512),(1024,544)
(640,864),(648,864),(648,608),(640,608),(640,864)
(544,1160),(736,1160),(736,1152),(544,1152),(544,1160)
(320,1152),(192,1152),(192,1160),(312,1160),(312,1184),(320,1184),(320,1152)
(160,1248),(160,1184),(168,1184),(168,1248),(160,1248)
}

spawns {
(0,864,224);(0,864,272);(0,864,320);(0,912,352);(0,816,352);(0,768,352);(0,720,352);(1,352,1264);(1,448,1264);(1,544,1264);(1,640,1264);(1,736,1264);(1,800,1264);(1,848,1264);
(2,864,224);(2,1088,160);(2,1120,832);(2,928,512);(2,576,512);(2,96,160);(2,224,384);(2,288,1088);(2,448,1216);(2,96,864);(2,512,928);(2,384,736);(2,224,736);(2,832,928);(2,1056,1056);(2,928,1248)
}

waypoints {
(592,336);(1072,208);(1200,80);(1168,208);(1200,384);(1200,576);(1008,384);(1200,1008);(1152,880);(1008,880);(1072,784);(928,1056);(816,928);(864,1008);(976,1008);(608,896);(592,800);(576,720);(704,656);(896,624);(928,576);(928,480);(912,400);(864,352);(688,352);(608,416);(608,512);(528,304);(432,272);(368,272);(288,272);(224,288);(160,288);(80,272);(80,208);(208,208);(96,160);(112,368);(112,448);(112,512);(96,576);(96,640);(224,368);(128,720);(144,768);(192,816);(192,912);(192,1008);(224,1072);(112,832);(432,736);(320,800);(112,1136);(96,1232);(144,1296);(240,1264);(256,1200);(304,1264);(480,1264);(592,1248);(736,1264);(832,1232);(688,1200);(816,1136);(592,1120);(512,928);(608,240);(576,224)
}

guns {
(18,352,1264);(18,448,1264);(18,544,1264);(18,640,1264);(18,736,1264);(17,864,224);(17,864,272);(17,864,320);(17,816,352);(17,912,352);(17,768,352);(17,720,352);(18,800,1264);(18,848,1264);(23,208,208);(23,1072,208)
}

flags {
(0,864,256);(1,640,1280)
}
